▣▣▣▣▣▣▣▣▣▣▣▣▣▣▣▣▣▣▣▣▣▣▣▣▣▣▣▣▣▣▣▣▣▣▣▣▣▣▣▣▣▣▣▣▣▣▣▣▣▣▣▣▣▣▣▣▣▣▣▣▣▣▣▣▣▣▣▣▣▣▣▣▣▣▣▣▣▣▣▣
▣                            ▣                            ▣                    ▣
▣   ▣▣▣▣                     ▣                            ▣                    ▣
▣   ▣▣▣▣                     ♨                            ▣                    ▣
▣                            ▣             ♣              ▣                    ▣
▣♣♣♣                         ▣             ♣              ♨                    ▣
▣♣♣♣♣    ▣▣▣▣▣▣▣▣            ▣                            ▣                    ▣
▣ ♣♣♣♣   ▣      ▣            ▣                            ▣                    ▣
▣  ♣     ▣      ▣            ▣                            ▣♨♨⧇⧇♨♨⧇⧇♨♨⧇⧇♨♨⧇⧇♨♨⧇⧇▣
▣        ▣      ▣▣▣▣▣▣▣▣▣▣▣  ▣                            ▣♨♨⧇⧇♨♨⧇⧇♨♨⧇⧇♨♨⧇⧇♨♨⧇⧇▣
▣   ☺♣   ▣                   ▣                            ▣                    ▣
▣        ▣                   ▣                            ▣                    ▣
▣        ▣▣▣▣▣▣▣▣▣▣▣▣▣▣▣▣▣▣▣▣▣                            ▣                    ▣
▣                            ▣                            ▣       ☠            ▣
▣                  ♣         ▣                            ▣                    ▣
▣                            ▣                            ▣                    ▣
▣♨♨▣▣▣▣▣♨▣▣▣▣▣▣▣▣▣▣▣▣▣▣▣▣▣   ▣                            ▣                    ▣
▣  ▣                     ▣   ▣                            ▣                    ▣
▣  ▣       ☠             ▣   ▣                            ▣                    ▣
▣♨♨▣           ☠         ▣   ▣                            ▣▣▣▣▣▣▣▣▣▣♨♨▣▣▣▣▣▣▣▣▣▣
▣  ▣                     ▣▣▣▣▣                            ▣       ♨♨♨♨♨♨       ▣
▣  ▣        ☠     ☠          ▣                            ▣       ♨♨♨♨♨♨       ▣
▣♨♨▣                         ▣                            ▣       ♨♨♨♨♨♨       ▣
▣  ▣▣ ▣▣▣▣▣▣▣▣▣▣▣▣▣▣▣▣▣▣▣▣▣▣▣▣            ♣♣♣♣♣♣          ▣                    ▣
▣  ▣                         ▣             ♣♣♣♣           ▣                    ▣
▣♨♨▣                         ▣                            ▣                    ▣
▣  ▣           ☿♗            ▣                            ▣                    ▣
▣  ▣                         ▣                            ▣          ⛤         ▣
▣                            ▣                            ▣                    ▣
▣▣▣▣▣▣▣▣▣▣▣▣▣▣▣▣▣▣▣▣▣▣▣▣▣▣▣▣▣▣▣▣▣▣▣▣▣▣▣▣▣▣▣▣▣▣▣▣▣▣▣▣▣▣▣▣▣▣▣▣▣▣▣▣▣▣▣▣▣▣▣▣▣▣▣▣▣▣▣▣