🟫🟫🟫🟫🟫🟫🟫🟫🟫🟫🟫🟫🟫🟫🟫🟫🟫🟫🟫🟫🟫🟫🟫🟫🟫🟫🟫🟫🟫🟫🟫🟫🟫🟫🟫🟫🟫🟫🟫🟫🟫🟫🟫🟫🟫🟫🟫🟫🟫🟫🟫🟫🟫🟫🟫🟫🟫🟫🟫🟫🟫🟫🟫🟫🟫🟫🟫🟫🟫🟫🟫🟫🟫🟫🟫🟫🟫🟫🟫🟫
🟫🌳            🟫🟫             🟫                 🟫   🟫🟫     🟫      🟫   🟫   🟫     🟫
🟫   🟫🟫🟫🟫                     🟫                            🟫                    🟫
🟫   🟫🟫🟫🟫                     🔥                            🟫                    🟫
🟫                            🟫             🌳              🟫                    🟫
🟫🌳🌳🌳                         🟫             🌳              🔥                    🟫
🟫🌳🌳🌳🌳    🟫🟫🟫🟫🟫🟫🟫🟫            🟫                            🟫                    🟫
🟫 🌳🌳🌳🌳   🟫      🟫            🟫                            🟫                    🟫
🟫  🌳     🟫      🟫            🟫                            🟫🔥🔥⬛⬛🔥🔥⬛⬛🔥🔥⬛⬛🔥🔥⬛⬛🔥🔥⬛⬛🟫
🟫        🟫      🟫🟫🟫🟫🟫🟫🟫🟫🟫🟫🟫  🟫                            🟫🔥🔥⬛⬛🔥🔥⬛⬛🔥🔥⬛⬛🔥🔥⬛⬛🔥🔥⬛⬛🟫
🟫   🤠🌳   🟫                   🟫                            🟫                    🟫
🟫        🟫                   🟫                            🟫                    🟫
🟫        🟫🟫🟫🟫🟫🟫🟫🟫🟫🟫🟫🟫🟫🟫🟫🟫🟫🟫🟫🟫🟫                            🟫                    🟫
🟫                            🟫                            🟫                    🟫
🟫                  🌳         🟫                            🟫                    🟫
🟫                            🟫                            🟫                    🟫
🟫  🟫🟫🟫🟫🟫🟫🟫🟫🟫🟫🟫🟫🟫🟫🟫🟫🟫🟫🟫🟫🟫🟫🟫   🟫                            🟫                    🟫
🟫  🟫                     🟫   🟫                            🟫                    🟫
🟫  🟫                     🟫   🟫                            🟫                    🟫
🟫  🟫                     🟫   🟫                            🟫🟫🟫🟫🟫🟫🟫🟫🟫🟫🟫🟫🟫🟫🟫🟫🟫🟫🟫🟫 🟫
🟫  🟫                     🟫🟫🟫🟫🟫                            🟫                    🟫
🟫  🟫                         🟫                            🟫                    🟫
🟫  🟫                         🟫                            🟫                    🟫
🟫  🟫  🟫🟫🟫🟫🟫🟫🟫🟫🟫🟫🟫🟫🟫🟫🟫🟫🟫🟫🟫🟫🟫🟫🟫🟫            🌳🌳🌳🌳🌳🌳          🟫                    🟫
🟫  🟫                         🟫             🌳🌳🌳🌳           🟫                    🟫
🟫  🟫                         🟫                            🟫                    🟫
🟫  🟫                         🟫                            🟫                    🟫
🟫  🟫                         🟫                            🟫                    🟫
🟫                            🟫                            🟫                    🟫
🟫🟫🟫🟫🟫🟫🟫🟫🟫🟫🟫🟫🟫🟫🟫🟫🟫🟫🟫🟫🟫🟫🟫🟫🟫🟫🟫🟫🟫🟫🟫🟫🟫🟫🟫🟫🟫🟫🟫🟫🟫🟫🟫🟫🟫🟫🟫🟫🟫🟫🟫🟫🟫🟫🟫🟫🟫🟫🟫🟫🟫🟫🟫🟫🟫🟫🟫🟫🟫🟫🟫🟫🟫🟫🟫🟫🟫🟫🟫🟫