▣▣▣▣▣▣▣▣▣▣▣▣▣▣▣▣▣▣▣▣▣▣▣▣▣▣▣▣▣▣▣▣▣▣▣▣▣▣▣▣▣▣▣▣▣▣▣▣▣▣▣▣▣▣▣▣▣▣▣▣▣▣▣▣▣▣▣▣▣▣▣▣▣▣▣▣▣▣▣▣
▣                            ▣                            ▣                    ▣
▣   ▣▣▣▣                     ▣                            ▣                    ▣
▣   ▣▣▣▣                     ♨                            ▣                    ▣
▣                            ▣             ♣              ▣                    ▣
▣♣♣♣                         ▣             ♣              ♨                    ▣
▣♣♣♣♣    ▣▣▣▣▣▣▣▣            ▣                            ▣                    ▣
▣ ♣♣♣♣   ▣      ▣            ▣                            ▣                    ▣
▣  ♣     ▣      ▣            ▣                            ▣♨♨⧇⧇♨♨⧇⧇♨♨⧇⧇♨♨⧇⧇♨♨⧇⧇▣
▣        ▣      ▣▣▣▣▣▣▣▣▣▣▣  ▣                            ▣♨♨⧇⧇♨♨⧇⧇♨♨⧇⧇♨♨⧇⧇♨♨⧇⧇▣
▣   ☺♣   ▣                   ▣                            ▣                    ▣
▣        ▣                   ▣                            ▣                    ▣
▣        ▣▣▣▣▣▣▣▣▣▣▣▣▣▣▣▣▣▣▣▣▣                            ▣                    ▣
▣                            ▣                            ▣                    ▣
▣                  ♣         ▣                            ▣                    ▣
▣                            ▣                            ▣                    ▣
▣  ▣▣▣▣▣♨▣▣▣▣▣▣▣▣▣▣▣▣▣▣▣▣▣   ▣                            ▣                    ▣
▣  ▣                     ▣   ▣                            ▣                    ▣
▣  ▣                     ▣   ▣                            ▣                    ▣
▣  ▣                     ▣   ▣                            ▣▣▣▣▣▣▣▣▣▣▣▣▣▣▣▣▣▣▣▣ ▣
▣  ▣                     ▣▣▣▣▣                            ▣                    ▣
▣  ▣                         ▣                            ▣                    ▣
▣  ▣                         ▣                            ▣                    ▣
▣  ▣  ▣▣▣▣▣▣▣▣▣▣▣▣▣▣▣▣▣▣▣▣▣▣▣▣            ♣♣♣♣♣♣          ▣                    ▣
▣  ▣                         ▣             ♣♣♣♣           ▣                    ▣
▣  ▣                         ▣              ☿             ▣                    ▣
▣  ▣                         ▣                            ▣                    ▣
▣  ▣                         ▣                            ▣                    ▣
▣                            ▣                            ▣                    ▣
▣▣▣▣▣▣▣▣▣▣▣▣▣▣▣▣▣▣▣▣▣▣▣▣▣▣▣▣▣▣▣▣▣▣▣▣▣▣▣▣▣▣▣▣▣▣▣▣▣▣▣▣▣▣▣▣▣▣▣▣▣▣▣▣▣▣▣▣▣▣▣▣▣▣▣▣▣▣▣▣